
WE ./image/501.xpm
NO ./image/502.xpm


SO ./image/503.xpm

EA ./image/504.xpm


F 184,113,39
C 51,198,227

        111111111111111111111111111
        1 1000000000110000000000001
        1 1011N00001110000000000001
       1111001000000000000000000001
11111111011000001110000000000001111
100000000011000011110111111111111
11110111111111011111100000010001
11110111111111011101010010001111
11000000110101011100000010001
1000000000000000110000001000111
1000000000000000011001010010001
1100000111010101111101111000111
11110111 1110101 101111010001
11111111 1111111 111111111111
