NO ./image/501.xpm

SO ./image/502.xpm

WE ./image/503.xpm

EA ./image/504.xpm

F 0,0,0

C -128,128,128

111111111
1W000001 1
100111111
100111111
100000001
100000001
111111111
